12 11
# # # # # # # # # # # #
# . . . . B h h h h h #
# h . B B h h . . . h #
> . . . . B H . T . . <
# h h h h h h H . . h #
# h h h h h h T . h h #
# h h h h h . . . T h #
# h h h h h . . . B h #
# h h h h h h . . . h #
# h h h h h h h . h h #
# # # # # # # # # # # #
