12 11
# # # # # # # # # # # #
# # # . . # # T # # # #
# # . . T . B B . # # #
# T . B . B . . . # # #
# # . . . # . . . # # #
# # # # # # # . # # # #
# # # # # # # T . . # #
# # # # # # # . . . P #
# # # # # # # . . . # #
# # # # # # # # . # # #
# # # # # # # # # # # #
