9 13
# # # # # # # # #
# h h . h h h h #
# h . T . h h h #
> . . . . h h h #
# h . . B h h h #
# h h . . h h h #
# h T B B h h h #
# h . . . . h h #
# h h . . B . h #
# h h B . . H H <
# h h h T B . h #
# h h h h . h h #
# # # # # # # # #
