8 9
X X X X X X X X
X h h E E E h X
> T E B E E h X
X X h E B T h X
X T h h B E h X
X E h E T E h X
X B E b B B T X
X E E E T E E <
X X X X X X X X
