13 9
# # # # # # # # # # # # #
# . . . # # # # # # # # #
# . . P # # # # # # # # #
# T B B # # # # # . . . #
# # # H . B . . # . B . #
# . . . . . . H T . . . #
# . B . # . . . # # . . #
# T . . # # . # # # # # #
# # # # # # # # # # # # #
