21 8
# # # # # # # # # # # # # # # # # # # # #
# h . . . h h h h . h h h h h h h h h h #
# h . . T h h h . . B h h h . h . . . . <
# . B . T . . B . . . H . . . . T . . . #
> T . . B . B . . B . h . B . . T . . . #
# h h h . . h h h . h h h H . . h h h h #
# h h h h h h h h h h h h h . h h h h h #
# # # # # # # # # # # # # # # # # # # # #
