6 11
# # # # # #
# # T # # #
# . H . # #
# P . . . #
# . . . . #
# # . # . #
# # B B B #
# # . B . #
# # . . H #
# # . # T #
# # # # # #
