9 11
# # # # # # # # #
# # # # T . . # #
# # . . . B H H <
# . . . . B . # #
# . . . # # # # #
# # . . # # # # #
# # T B # # # # #
# . . . # # # # #
# . B B . # # # #
> . . . # # # # #
# # # # # # # # #
