6 11
# # # # # #
# H H . H #
# T B . H <
> . . T . #
# H . . . #
# H . . H #
# H B . H #
# H . . . #
# H . B . #
# H . . H #
# # # # # #
