6 11
# # # # # #
# h h . h #
# T B . H <
> . . T . #
# h . . . #
# h . . h #
# h B . h #
# h . . . #
# h . B . #
# h . . h #
# # # # # #
